.....*.....
..*******..
.**@***@**.
.*@@@*@@@*.
.**@***@**.
*****^*****
.****^****.
.**_____**.
.*********.
..*******..
.....*.....
@*@
***
*^*
